Adamantium=Adamantium
Material=材料
Leaf=叶
Lead=铅
Thallium=铊
Triunquadium=Triunquadium
Bituminous=沥青
Canvas=帆布
Sugar=糖
Stibnite=Stibnite
Communism=共产主义
Triseptunium=三ium
Anti-Ununtrium=反Ununtrium
Hammers=锤子
Compression=压缩
Plate=盘子
Halogen=卤素
Fluid=流体
Fluix=Fluix
worth=价值
GT=GT
Blade=刀
Turbines=涡轮机
Anti-Bitriseptium=抗百日咳
Lanthanide=镧系元素
Pipe=管
Oxide=氧化物
every=每个
Obsidian=黑曜石
Brew=酿造
Bipentennium=二十一世纪
Steak=牛扒
Automatic=自动
Steam=蒸汽
look=看
Krypton=氪
Anti-Unseptennium=抗 - 无锑
Ignatius=Ignatius
Shears=剪
Electrolysable=可电解
wooden=木
Hopper=料斗
Anti-Iridium=反铱
Taste=味道
Tritanium=Tritanium
Anti-Tripenthexium=抗三膜念珠菌
Gadolinium=钆
Electrum=Electrum
Bipentbium=铋
Anti-Biquadtrium=抗二rium
Rotor=转子
Stack-O-Meter=堆栈O-Meter
Max=最大
Bender=弯曲
Yellorium=Yellorium
Bibipentium=Bibipentium
Pyrotheum=Pyrotheum
Unbipentium=Unbipentium
Anti-Bihexennium=反双年份
Rubracium=Rubracium
Bihexnilium=Bihexnilium
Anti-Triseptoctium=抗三鞭虫
Voltage512=电压512
Biennhexium=双烯诺
Pickaxe=镐
Flattened=扁平
Put=放
Uraninite=Uraninite
Anti-Bioctunium=反生物化学
ever=永远
Iridiron=Iridiron
Spodumene=锂辉石
Made=制作
Biquadoctium=Biquadoctium
Yttrium-Barium-Cuprate=钇 - 铜酸盐
Items=项目
Greenstone=绿玉
Adjusts=调整
here=这里
Accesses=访问
搂r搂f搂lWIP搂r搂7=§17
active=活性
Indium=铟
Cold=冷
Anti-Triunoctium=反三极管
Queen=女王
Anti-Unsepthexium=抗 - 不肖氏
Anti-Bipentoctium=抗双歧杆菌
Voltage=电压
NOT=不
Alternative=替代
suitable=适当
Hydrogen=氢
Wrought=锻
Vyroxeres=Vyroxeres
golden=金色
Wire=线
Group=组
magically=神奇
Fibers=纤维
Support=支持
UV-PUV1=UV-PUV1
BioMass=生物质
Bucket-O-Meter=桶-O米
Bihexunium=Bihexunium
Also=也
AshesVolcanic=灰烬火山
Book=书
Health=健康
Trees=树木
Basic=基本
Detector=探测器
Anti-Tritrihexium=抗三联素
Nitride=氮化物
Star=星
Polonium=钋
would=将
Efficiency=效率
Potassium=钾
achieve=实现
Mooshrooms=房间
Unseptquadium=未知
Anti-Unoctoctium=抗unoctoctium
Foil=挫败
Tritrioctium=三叉ium
call=呼叫
Compressed=压缩
Lighter=打火机
Bookshelf=书架
Carbon=碳
Anti-Biununium=抗生素
until=直到
1000=1000
Anti-Triquadpentium=反三重峰
Sorting=排序
Anti-Unennilium=抗枝蕨
NaturalAluminum=天然铝
Unquadtrium=Unquadtrium
Anti-Unquadquadium=反非常规
Anthracite=无烟煤
Flerovium=Flerovium
Smelting=冶炼
CyprusVitriol=塞浦路斯三联
Volcanic=火山
Indigo=靛青
Anti-Tribiunium=抗Tribiunium
Dioptase=Dioptase
work=工作
Tin=锡
Ectoplasm=外胚层
Anti-Copernicium=反贵族
Specified=指定
Partially=部分
Bioctnilium=生物化学
example=例
Fluorine=氟
Grindable=可磨
Magnalium=Magnalium
NaquadahAlloy=Naquadah合金
Chrome=铬
Lin=林
Reality=现实
Sealed=密封
Creosote=Creosote
Anti-Tribihexium=抗Tribihexium
Ilmenite=钛铁矿
Banana=香蕉
Voltage8192=电压8192
Wolframite=Wolframite
Apatite=磷灰石
LV=LV
how=怎么样
hot=热
LU=鲁
adjacent=邻
VolcanicAsh=火山灰
Rum=朗姆酒
Certified=认证
A=一个
dismantles=拆除
RefinedObsidian=RefinedObsidian
Pulverisation=粉碎
thingy=东西
2.0=2.0
Tellurium=碲
Rotors=转子
Extruder=挤出机
Roaster=焙烧炉
All=所有
Ender=恩德
Untriquadium=不锈钢
Binilunium=Binilunium
Grossular=毛重
Sluice=水闸
Astatine=Ast
Curved=弯曲
Crystalline=结晶
order=订购
Triunnilium=三年生
Blue=蓝色
Anti-Unquadtrium=反Unquadtrium
Sticks/Rods=棒/棒
Eye=眼
Monoxide=一氧化碳
Untripentium=Untripentium
Sub-Block=子块
Wirecutter=钢丝钳
over=过度
Unquadunium=Unquadunium
Approximate=近似
Rotten=烂
Signalum=Signalum
Anti-Trihexunium=抗三萜
Tips=提示
before=之前
Perlite=珍珠岩
Limonite=褐铁矿
2:00=2:00
Anti-Unhexquadium=反Unhexquadium
Raisins=葡萄干
Molecule=分子
Biniltrium=Biniltrium
better=更好
Ore-Dictionary=矿石词典
differently=不同
Legendary=传奇的
Emerald=翠
Anti-Holmium=抗钬
then=然后
them=他们
Anti-Tribinilium=抗Tribinilium
Pumice=浮石
Rhyolite=流纹岩
Voltage131072=电压131072
finish=完
Thick=厚
Ferrovanadium=铁钒
Anti-Thulium=抗ium
Arrow=箭头
Chalcopyrite=黄铜矿
Biotite=黑云母
yourself=自己
Control=控制
Unquadpentium=未夸脱
Vodka=伏特加
Tribihexium=Tribihexium
Anti-Plutonium-243=抗钚-243
Anti-Plutonium-241=抗钚-241
Pahoehoe=Pahoehoe
filling=填充
air-free=无空气
Tourmaline=电气石
Trioctbium=三锑
Anti-Bipentunium=抗双翅目
Plow=犁
Dense=稠密
Pure=纯
Bacon=培根
Anti-Triseptseptium=抗三肽菌
Triseptpentium=三卟啉
Veggie=蔬菜
Damascus=大马士革
Unbinilium=副酮
KnightMetal=骑士金属
Bibihexium=Bibihexium
Type=类型
Transmutation=转化
lait=笑
Anti-Flerovium=抗Flerovium
Ever=永远
Wart=疣
Fullers=Fullers
cheesy=奶酪
content=内容
Restrictive=限制性
alloying=合金化
Anti-Selenium=抗硒
Anti-Untrioctium=抗非教
Anti-Francium=反腐
Ununseptium=Ununseptium
got=得到
Hold=保持
Super=超
Anti-Unennbium=抗Unennbium
accidentially=意外
ENERGY.CRYO=ENERGY.CRYO
Lapis=Lapis
Metal=金属
Quartz=石英
Nutmeg=肉豆蔻
Circuit=电路
Anti-Bibitrium=抗铋
Kesterite=蛭石
Soft=柔软的
Chad=乍得
Servers=服务器
Buildcraft=Buildcraft
Titanium=钛
Unbibium=Unbibium
BeesWax=蜂蜡
Cafe=咖啡店
Helium=氦
Anti-Bitrinilium=抗Bitrinilium
Farnsium=法恩
already=已经
Ferberite=辉铜矿
Adamite=亚当特
Cell=细胞
Buns=面包
Coagulator=凝结器
closest=最近
another=另一个
Piston=活塞
thick=厚
Screw=拧
Tetrahedrite=四面体
Ryu=Ryu
needed=需要
Anti-Copper=抗铜
Press=按
Peanutwood=花生豆
Rare=罕见
Onion=洋葱
Vanadium=钒
emit=发射
Trioctpentium=三铌
Scheelite=白钨矿
Unoctoctium=。
Mimichite=Mimichite
Fum=Fum
Post=帖子
Exquisite=精美
Anti-Trihexnilium=抗Trihexnilium
Crusher=破碎机
Voltage8=电压8
Unennoctium=Unennoctium
Torrentuga=Torrentuga
Bioctpentium=生物化学
matter=物
H2O=H2O
Sea=海
Anti-Unoctnilium=抗unoctnilium
Anti-Biquadoctium=抗茯苓
Anti-Unennoctium=抗真菌
raw=生的
Crab=螃蟹
seen=看到
mins=分钟
Nichrome=镍铬合金
Tribinilium=Tribinilium
Ununpentium=Ununpentium
Gravitonium=墓碑
Component=零件
Rate=率
Hexaiodide=六碘化物
Anti-Tripentennium=反三年
Mixing=混合
Carbide=碳化物
overclocked=超频
RyuDragonRyder=RyuDragonRyder
exactly=究竟
Meat=肉
Comparator=比较器
Button=按钮
Anti-Berkelium=抗Berkelium
Gneiss=Gneiss
regular=定期
Table=表
Hexadecimal=十六进制
Tin.This=锡
Triununium=三ium
Side=侧
Bone=骨
known=已知
Enderbloom=Enderbloom
QU=QU
Terrasteel=Terrasteel
Quality=质量
Witheria=威尼斯
flow=流
Scene=现场
Anti-Trihexquadium=抗三秩梯
Pomeraisins=番木瓜
Single=单
Magnetite=磁铁矿
Acid=酸
Its=它的
Dirty=脏
Bibiseptium=二苯
Lait=笑
selected=选择
Conversion=转换
Angmallen=Angmallen
Plumbilia=Plumbilia
Amethyst=紫晶
Binilpentium=Binilpentium
Anti-Unennennium=反千年
Beeswax=蜂蜡
Anti-Sodium=抗钠
Unificatable=无可比拟
Resources=资源
Meteoric=流星
Bio=Bio
Strips=带子
Anti-Polonium=抗onium
Big=大
Anti-Biocthexium=抗生素
Ammonium=铵
Coinage=硬币
Stripe=条纹
Bronze=青铜
do=做
GregTech=GregTech
Multitool=多功能工具
10=10
Turns=转身
stop=停止
Days=天
Extrudable=可挤压
15=15
Triunpentium=三仲
Anti-Bihexbium=防铋
Anti-Tritritrium=抗Tritritrium
Anti-Germanium=抗锗
Anti-Ununseptium=抗Ununseptium
2:15=2:15
Untrinilium=Untrinilium
Dropped=掉了
Oven=烤箱
Unhexennium=未来
Unbiennium=未来
Purified=纯化
Anti-Deuterium=抗氘
Anti-Trihextrium=抗三叶草
3:00=3:00
Glen=格伦
Triquadpentium=三重态
Titan=Titan
Branch=科
Bipenthexium=双翅目
Infinitely=无限地
Anti-Tellurium=抗碲
Short=短
result=结果
Anti-Unquadunium=反Unquadunium
Biuntrium=Biuntrium
hammer=锤子
Dogs=小狗
best=最好
Basalz=Basalz
Gluten=麸质
Americium-241=ium -241
Auto=汽车
Tool=工具
Basalt=玄武岩
BUT=但
Water=水
Cobblestone=鹅卵石
Biununium=Biununium
ULV-LV=ULV-LV
Hexafluoride=六氟化物
Advanced=高级
Spawners=产卵器
Dusts=灰尘
KU=KU
Counter=计数器
Tree=树
however=然而
Unpentoctium=Unpentoctium
Shapes=形状
Tritriunium=Tritriunium
Anti-Unoctunium=抗unoctunium
Anti-Unpentnilium=抗Unpentnilium
Biniloctium=二ilo
5x=5x
Cylinder=圆筒
Unennhexium=Unennhexium
Logs=日志
Andradite=安德拉德
Covers=盖子
Draconium=Draconium
Computes=计算
Anti-Adamant=反金刚
Unstableingot=不稳定
Arrows=箭头
Supporter=支持者
Compact=紧凑
Greywacke=Greywacke
Boars=野猪
Trona=Trona
Electricity=电力
Weak=弱
Petroleum=石油
Snow=雪
ENERGY.VIS_AER=ENERGY.VIS_AER
Anti-Unhexennium=反千年
16x=16x
Board=板
Anti-Bipentseptium=抗二肽
Electrolyzer=电解槽
Method=方法
strong=强大
Blocks=块
Ruthenium=钌
Curry=咖喱
Anti-Bromine=抗溴
Amordrine=Amordrine
Dimension=尺寸
Trihextrium=Trihextrium
Biquadtrium=Biquadtrium
Chance=机会
much=许多
Cucumber=黄瓜
basic=基本
Anti-Trioctoctium=抗三肌苷
Anti-Untritrium=抗解
Tomato=番茄
life=生活
Toggles=切换
Vibrant=充满活力
Flow=流
Zirconium=锆
Boules=Boules
Concrete=具体
Bioctoctium=生物化学
Night=晚
Tribibium=ium
Triennhexium=三年
CU=CU
Anti-Nobelium=抗诺贝尔
Workbench=工作台
Triseptquadium=Triseptquadium
Area=区
Anti-Trinilhexium=抗三六六
Attraction=吸引力
Process=处理
Averaging=平均
Into=进入
Anti-Biseptbium=抗双磷
Dried=干
Bioctseptium=生物化学
spawn=产卵
Anti-Mendelevium=抗门防治
Iodide=碘
Pyrolusite=软骨矿
is=是
dumped=倾倒
it=它
HSLA-Steel=HSLA钢
Unoctpentium=。
Ideal=理想
Basaltic=玄武岩
Anti-Biquadseptium=抗二肽
Sword=剑
in=在
Bipentnilium=百草枯
if=如果
containing=含有
Anti-Trioctnilium=抗三尖椒
Gear=齿轮
Anti-Trihexseptium=抗三己酶
things=东西
make=使
Stop=停止
Anti-Bipentbium=抗双生子
Wires=电线
Lemons=柠檬
Sylvite=Sylvite
Cells=细胞
Goku=悟空
Distance=距离
Electromagnet=电磁铁
Sphalerite=Sphalerite
Anti-Bihexunium=抗Bihexunium
Biseptquadium=Biseptquadium
hand=手
Owner=所有者
Protactinium=镤
Biquadnilium=Biquadnilium
Bedrock-HSLA-Alloy=Bedrock-HSLA合金
Pincers=钳
Distillery=酒厂
Anti-Biseptunium=抗双卟啉
Bioctunium=生物化学
Bouncy=弹性
Smithable=史密斯
ATTACK=攻击
Coffee=咖啡
Lazurite=青金石
the=的
Mint=薄荷
Butchery=屠杀
Anti-Neutron=抗中子
Bihexhexium=Bihexhexium
Status=状态
Truth=真相
just=只是
able=能够
Forcicium=Forcicium
Trioctnilium=三辛酸
Anti-Uran=反铀
AluminumBrass=铝制
Anti-Biquadnilium=抗二ium
extracted=提取
adding=添加
Jet=喷射
Samarium=钐
Relays=继电器
Reacts=反应
Gas=加油站
Boilers=锅炉
Trioxide=三氧化物
Flint=燧石
has=具有
Reset=重启
usable=可用
Anti-Triennseptium=抗三联药
Bipentquadium=双ent
Taking=采取
looks=看起来
possible=可能
Invisible=无形
Zectium=ium
Wrench=扳手
6:00=6:00
usually=通常
advanced=高级
Wine=红酒
Essentia=Essentia
Anti-Unpentunium=防万能
Biquadhexium=双季铵
Bitribium=Bitribium
shaped=成形
Alunite=Alunite
Sheldonite=谢尔顿
Anti-Meitnerium=抗米
Smelt=冶炼
MV-HV=MV-HV
Anti-Livermorium=反地钱草
people=人
Hexaastatide=六酰化
Anti-Bioctpentium=抗生物药
HV=HV
Anti-Carbon-14=抗碳-14
HU=HU
Beer=啤酒
Bees=蜜蜂
Distilled=蒸馏
Anti-Biunennium=反双年
Life=生活
Cube=立方体
Bolts=螺栓
Energium=能量
Safe=安全
Awkward=尴尬
everything=一切
Tripenthexium=Tripenthexium
Let=让
Meutoite=Meutoite
Anti-Trioctunium=抗三ium
byproduct=副产品
Anti-Promethium=抗ium
Gray=灰色
Replaces=替换
Instant=瞬间
Anti-Unsepttrium=抗非小管
Deuterium=氘
Place=地点
Spidernip=Spidernip
Crystallisation=结晶
Anti-Binilbium=抗二铌
properties=属性
Amber=琥珀色
Anti-Xenon=反氙气
Trinilennium=三年
Thyrium=Thyrium
Ceramic=陶瓷
o=o
Arm=臂
Juicer=榨汁机
Biquadquadium=Biquadquadium
Converts=转换
Powder=粉末
Still=仍然
slightly=略
Corn=玉米
Machines=机器
Mode=模式
Use=使用
Antimony=锑
Anti-Trisepthexium=抗三胰岛素
Anti-Strontium=抗锶
Poison=毒
insert/extract=插入/提取
Anti-Vibranium=抗眩
Schist=Schist
Anti-Binilhexium=抗二Bin
Fiery=火热
old=旧
Astral=Astral
non-Thaumaturgic=非Thaumaturgic
Anti-Triunquadium=反Triunquadium
Panels=面板
Unseptunium=非。
Apples=苹果
Triennseptium=Triennseptium
Anti-Bisepttrium=抗双卟啉
Extender=扩展器
Tritrinilium=三腈
Anti-Carbon-13=抗碳-13
Device=设备
Blast=爆破
Ketchup=番茄酱
Anti-Tribitrium=抗庭院
Bread=面包
MERCY=怜悯
form=形成
some=一些
Soulium=豆腐
Aqua=Aqua
Anti-Trinilunium=抗三痣
Anti-Tritriennium=反三年
Anti-Radium=抗镭
Radaway=Radaway
Tiny=小
Biquadennium=二十一世纪
Soda=苏打
Anti-Triniloctium=抗三叉戟
Planks=木板
Plutonium=钚
Left=剩下
Golden=金色
input=输入
Anti-Tin=防锡
Carborundum=金刚砂
inside=内
Torch=火炬
attached=附件
Tine=Tine
different=不同
Attempts=尝试
Diatomite=硅藻土
Neutrino=Neutrino
more=更多
average=平均
Cream=奶油
3.0=3.0
up=向上
ENERGY.REDSTONE_FLUX=ENERGY.REDSTONE_FLUX
Pitchblende=Pitchblende
Crates=板条箱
Anti-Gadolinium=抗钆
Anti-Tripenttrium=抗Tripenttrium
Triennpentium=Triennpentium
Anti-Photon=抗光子
promised=承诺
Holmium=钬
Dioxide=二氧化物
Anti-Unbiseptium=抗Unisisium
holy=圣
weakened=弱化
Track=跟踪
Weakness=弱点
Mayo=Mayo
when=什么时候
Bohrium=Bohrium
Sub-Item=子项目
Anti-Bitripentium=抗Bitripentium
holding=保持
Andesite=安山岩
Latex=胶乳
Eximite=Eximite
Whacking=打仗
Double=双
Anti-Manganese=抗锰
Anti-Tripentpentium=抗Tripentpentium
Obscurator=阴影
Peroxide=过氧化物
Layered=分层
UNITE=团结
Triennquadium=Triennquadium
Anti-Beryllium=抗铍
Anti-Triennquadium=反铁人
Trisepttrium=Trisepttrium
Bioctennium=生物多样性
for=对于
Tritium=氚
Color=颜色
Graphene=石墨烯
Resistant=耐性
together=一起
Anti-Naquadah=反Naquadah
Second=第二
teleported=传送
Displays=显示
So=所以
Anti-Biseptoctium=抗双活细菌
Bipenttrium=双rium
precise=精确
Shard.You=谢谢
Sulfate=硫酸盐
Grilled=烤
Biseptennium=Biseptennium
Anti-Triquadnilium=抗三叶草
Quartzite=石英岩
Infuscolium=ium
ENERGY.LIGHT=能源
Inputs=输入
Anti-Hassium=抗-H
Anti-Triseptunium=抗三卟啉
environment=环境
0=0
finally=最后
Lighting=灯光
Bolt=螺栓
Bihexquadium=Bihexquadium
Untriennium=未成年
Anti-Unseptpentium=抗非萜类
Molybdenite=辉钼矿
Terbium=铽
Socket=插座
Bauxite=铝土矿
Notches=凹口
Anti-Biocttrium=抗生素
Flawless=无瑕
Duff-Lite=Duff-Lite
Tech=技术
Ferru=Ferru
Unhexhexium=Unhexhexium
Where=哪里
Ores=矿石
Amperage=电流
Semifluid=半流体
Just=只是
die=死
Withereed=愿意
Boule=Boule
Hexabromide=六溴化物
burned=烧毁
Untriunium=不相关
Magnifying=放大
Teslatite=Teslatite
Tables=表
Firestone=火石
be=是
Tripentpentium=Tripentpentium
Blazereed=Blazereed
Chops=剁
Wet=湿
Sprays=喷雾
Anti-Quicksilver=防水银
Orange=橙子
Rice=白饭
Red=红
Nectar=花蜜
Charcoal=木炭
Head=头
Nickel=镍
Form=形成
Brewing=酿造
Helium-3=氦-3
Anti-Bioctennium=反生物化
Werebane=Werebane
Untriseptium=无菌
Einsteinium=ium
Chum-balaya=Chum-balaya
Mineral=矿物
Mc=Mc
water=水
Admins=管理员
Moonstone=月长石
Berry=浆果
ENERGY.TIME=ENERGY.TIME
Cornmeal=棒子面
Breaker=断路器
change=更改
wait=等待
healthy=健康
Cheesy=奶酪
Recyclable=可回收
MV=MV
Entropy=熵
Anti-Thallium=抗铊
Technology=技术
Anti-Tritripentium=抗三叉戟
Flerovium-298=Flerovium-298
Anti-Trihexpentium=抗三次
Quadruple=四人
Anti-Californium=抗。
Diareed=Diareed
It's=它的
Anti-Tribiseptium=抗三裂纹
Enderpearl=Enderpearl
Seaborgium=海棠
Performs=施行
Anti-Triocthexium=抗三氯痛
nauseating=恶心
Beryllium=铍
red=红
Anti-Unpenthexium=抗非堆积
Cobalt-60=钴-60
Graveyard=墓地
Anti-Untriquadium=反非法
Automation=自动化
going=去
Slimeplant=Slimeplant
Anti-Unennquadium=反Unennquadium
sharpen=锐化
selects=选择
Valve=阀
Neptunium=ium
Anti-Aluminum=防铝
Sugary=含糖
Leather=皮革
Mortar=砂浆
Weapon=武器
Tons=吨
Raisin=葡萄干
Bee=蜜蜂
Ashes=灰烬
Triquadoctium=Triquadoctium
Unenntrium=Unenntrium
Siltstone=沉淀
Mortal=凡人
Requires=需要
Unseptennium=未ium
Anti-Biennquadium=反Biennquadium
Dump=倾倒
Tripentquadium=Tripentquadium
Magnetic=磁性
Bath=浴
Locks=锁
diverse=多样化
sour=酸
Anti-Bipenttrium=抗双鞭虫
Appliances=电器
Sperrylite=Sperrylite
Glue=胶
Anti-Unbiennium=反新千年
Children=儿童
Spade=铲
Ground=地面
Centrifuge=离心机
Unoctunium=Unoctunium
HSLA=HSLA
Hafnium=铪
Monkey=猴
Anti-Triquadunium=抗三叶虫
Scrap=废料
Contains=包含
Cheeseburger=乳酪汉堡
Stannic=斯坦尼克
239=239
Swiftness=迅捷
Pizza=比萨
Blutonium=onium
Noble=高贵
Missing=失踪
Anti-Lantanium=抗兰
Stretchy=Stretchy
Coke=可乐
Prismane=Prismane
Prometheum=Prometheum
Irridant=Irridant
Unhexquadium=Unhexquadium
Redstoned=Redstoned
Tungsten=钨
Carbon-13=碳-13
Emitter=发射器
Carbon-14=碳-14
Stretched=拉伸
Promethium=ium
Twigs=树枝
Tank=坦克
Modes=模式
teleport=传送
may=可能
Always=总是
Anti-Bioctnilium=抗生素
Anti-Trisepttrium=抗Trisepttrium
Triennoctium=Triennoctium
Atlarus=阿特拉斯
Dynamo=发电机
such=这样
Trihexquadium=三六角
Rightclick=右键点击
Anti-Cerium=抗铈
Iodine=碘
Burning=燃烧
Anti-Lithium=抗锂
Redstone=红石
Mac-Guffium=Mac-Guffium
switch=开关
Lightning=闪电
Mold=模子
Tribioctium=枯草
Ordo=Ordo
ENERGY.KINETIC_ROTATION=ENERGY.KINETIC_ROTATION
Sheet=片
Anti-Ununpentium=反Ununpentium
Generator=发电机
Lutetium=镏
Removal=删除
Strength=强度
Lithium-6=锂-6
cuts=切割
White=白色
Anti-Triquadhexium=抗三联疫苗
Americium=ium
Trioctquadium=三角球
RU=RU
Direction=方向
Welder=焊机
Anti-Untripentium=抗Untripentium
Bitritrium=Bitritrium
Rail=轨
Screwdriver=螺丝刀
RE=回覆
RF=RF
Cannot=不能
Effects=效果
Saphire=Saphire
RO=RO
Regia=Regia
Charger=充电器
Lemurite=Lemurite
Cable=电缆
Starconium=Starconium
Anti-Bipentennium=反双年纪
Prismarine=海军陆战队
shatter=粉碎
Anti-Actinium=抗锕
Impure=不纯
Right=对
TPS=TPS
Ultimate=最终
half=半
not=不
Triquadseptium=三重态
Wheaty=小麦
Hemp=麻
nor=也不
Dogmeat=狗肉
down=下
Stores=商店
Bromargyrite=铬铁矿
Anti-Arsenic=抗砷
Bioctbium=生物bium
Yellow=黄色
Stored=存储
Simply=只是
ENERGY.STEAM=能源
Adluorite=荧石
Kilotons=Kilotons
Anti-Bibiennium=反双年展
Milk=牛奶
Earths=地球
retrieve=检索
Unhextrium=Unhextrium
Smithsonite=史密斯顿
Triquadtrium=三重四级
Biennennium=两年期
Biseptbium=双卟啉
Enriched=丰富
Bitriseptium=百度文库_
Anti-Unbihexium=抗Unhexhexium
Anti-Bitriunium=抗咬虫
Knife=刀
Shovels=铲子
shown=显示
Anti-Indium=抗铟
opened=打开
Eclogite=Eclogite
Sauce=酱
Anti-Triniltrium=抗三膜
Pocket=口袋
contained=包含
Key=键
Transfers=转移
Throw=扔
Booster=助推器
Electron=电子
Rutherfordium=芦苇
Stone=石
Bibitrium=胫骨
monster=怪物
Triennennium=三年期
Sometimes=有时
Smooth=光滑
Magical=神奇
Mixer=混合器
Triunseptium=三重肽
Mixed=混合
Gramm=语法
care=关心
Miniature=微型
Matter=物
Battery=电池
Anti-Unpentpentium=反未卷曲
Normal=正常
purpose.To=目的
place=地点
Triple=三倍
Aerotheum=Aerotheum
Generates=生成
Bitrinilium=Bitrinilium
Anti-Roentgenium=抗根
first=第一
Vibranium=ium
Komatiite=Komatiite
DarkAsh=黑暗
Anti-Biunpentium=抗Biunpentium
Anti-Helium=抗氦
Stainless=不锈钢
Unpentennium=未百年
one=一
Hexahydrate=六水合物
Black=黑色
Weakening=弱化
open=打开
Unsepttrium=未知
Trihexbium=三重铽
Diamond=钻石
Transformers=变形金刚
Tripentennium=三年
1x=1x
Anti-Trinilpentium=抗三铌
Crushed=碎
Selenite=亚硒酸盐
Binilnilium=iln
Scandium=钪
Every=每一个
Crushes=粉碎
Hematite=赤铁矿
Data=数据
gives=给出
mining=矿业
way=办法
mostly=大多
that=那
Rings=戒指
Ribs=肋骨
Anti-Triunseptium=抗三肽
x8=x8
Cinnamon=肉桂
Ingots=锭
PhasedGold=PhasedGold
Spawn=产卵
Anti-Biennhexium=抗二十一
Anti-Tribipentium=抗三叉戟
Anti-Ruthenium=抗钌
AntiElectron=反电子
16=16
Anti-Bitritrium=抗Bitritrium
require=要求
Anti-Biseptnilium=抗双嘧啶
Ludicrite=Ludicrite
Lepidolite=锂云母
0:45=0:45
UUM=UUM
Magma=岩浆
Tantalite=Tantalite
Tribitrium=Tribitrium
and=和
Anti-Tribioctium=抗枯草
Pentoxide=五氧化物
Container=容器
mundane=世俗
Biseptseptium=双嘧啶
Diduranium=Diduranium
Field=领域
tastes=口味
Anti-Oxygen=抗氧
Thermometer=温度计
1=1
Trash=垃圾
any=任何
Molds=模具
Do=做
Sails=风帆
Anti-Tritrinilium=抗三腈
Soapstone=滑石
Pomegranate=石榴
Anti-Unennhexium=抗Unennhexium
Anti-Trihexennium=反三年期
take=采取
Wulfenite=亚硫酸盐
Cubes=立方体
multiple=多
Anti-Unoctennium=反古老
Ignites=点击
Igniter=点火器
Roasted=烤
Strawberry=草莓
Anti-Bioctquadium=抗生素
multiply=乘
Awakened=觉醒
Rocks=岩石
Filter=过滤
Cocaine=可卡因
Anti-Potassium=抗钾
Amplifier=放大器
Mince=剁碎
Module=模块
OUT=OUT
Actively=积极
Galena=Galena
PhasedIron=PhasedIron
Triniloctium=三叉戟
Substitute=替代
Polarizer=偏振器
essentia=essentia
Anti-Hafnium=抗铪
Livermorium=肝藤
Binilbium=二元锰
Anti-Nitrogen=抗氮
Absorber=吸收器
discovered=发现
Kilogramme=公斤
Triocttrium=Triocttrium
Chip=芯片
Voltage2147483647=电压：2147483647
Roll=滚
slow=慢
Unoctseptium=解开
Hull=船体
Bottom=底部
enough=足够
Grenade=手榴弹
only=只要
wood=木
Solar=太阳能
Tripentunium=Tripentunium
Anti-Unseptbium=抗菌素
Ignis=Ignis
GarnetRed=加仑
get=得到
Sulfuric=硫酸
Biunennium=两年
Tripentnilium=Tripentnilium
Synthesisable=可合成
Large=大
Anti-Rhodium=抗铑
cannot=不能
Draconic=龙脉
secondary=次要
Soularium=Soularium
Ultimet=Ultimet
Anti-Farnsium=抗金属
Petrotheum=Petrotheum
Anti-Unbioctium=抗樟脑
Wolframsteel=Wolframsteel
Feldspar=长石
Magenta=品红
where=哪里
Anti-Biniltrium=抗二线
Tripentbium=Tripentbium
Filterable=可过滤
Ticks=蜱
Storage=存储
Buzzsaw=电锯
Ironwood=铁木
Quicklime=生石灰
Inventory=库存
Blossoms=开花
Anti-Unpentennium=反千年
Rhodium=铑
PUV1=PUV1
Alduorite=Alduorite
That=那
Breaks=休息
Prefix=字首
Anti-Lutetium=抗镥
Hours=小时
Triunbium=三bium
metallum=金属
Natrium=钠
Salty=咸
Tribipentium=三叉戟
Cassiterite=锡石
Kyanite=蓝晶石
emitted=发射
Natural=自然
Oats=燕麦
Engraver=雕刻
Sense=感
Scissors=剪刀
Energizers=激励
Unpentseptium=无菌
Anti-Thorium=抗钍
Facing=面对
Rubidium=铷
Bioctquadium=生物化学
Scaffolded=脚手架
many=许多
Anti-Trioctennium=反三年
1:30=1:30
Anti-Triseptpentium=抗三萜
Anti-Biquadbium=抗双bium
Germanium=锗
somewhere=某处
Anti-Unquadseptium=反非灭菌
Haderoth=Haderoth
Biennquadium=Biennquadium
Bihexseptium=Bihexseptium
Arsenic=砷
Brittle=脆
Anti-Unenntrium=抗Unenntrium
comes=来吧
Trinilunium=三ium
Europium=铕
Engines=引擎
Passively=被动地
Hexachloride=六氯化物
Pearl=珍珠
Borax=硼砂
Unseptpentium=未知
Trinilbium=三铌
Anti-Tribibium=抗Tribibium
Hepatizon=肝癌
Pepper=胡椒
Assembly=部件
Electric=电动
Anti-Unpentquadium=反Unpentquadium
Anti-Zirconium=抗锆
Painite=Painite
Craponite=霞石
Optical=光学
Bun=包子
Stick=棒
Tanks=坦克
Dolomite=白云石
Kalium=Kalium
QUEWWW-CUMMM-BURRR=QUEWWW-CUMMM-BURRR
Crafting=制作
enable=启用
Russellite=罗素
Lantanium=。
Vanilla=香草
Quicksilver=水银
Osmiridium=Osmiridium
Voltage32=电压32
metals=金属
Peanut=花生
Anti-Bibibium=抗璧
careful=小心
Scotch=苏格兰人
Round=回合
Bihexbium=Bihexbium
ENERGY.HEAT=ENERGY.HEAT
CO2=CO2
stacked=堆叠
Anti-Binilpentium=反二叶草
Anti-Dubnium=反丁香
Splash=溅
ignition=点火
Bastnasite=Bastnasite
Quantum=量子
Level=水平
Open=打开
Causes=原因
Size=尺寸
Slot=插槽
aluminium=铝
Slice=片
Conveyor=输送带
Sake=清酒
Grindstone=磨石
Selenium=硒
Bibiunium=Bibiunium
Oat=燕麦
Aquamarine=蓝晶
Forcillium=ium
Infernal=地狱
Chrysocolla=Chrysocolla
Argentia=阿根廷
Plant=厂
Endstone=Endstone
Void=空隙
Sneak=潜行
Diodes=二极管
Anti-Triennpentium=抗Triennpentium
Stepsize=步骤
Blood=血液
Ethanol=乙醇
distilled=蒸馏
Silver=银
Anti-Biennunium=反双子楼
Whisky=威士忌酒
Anti-Osmium=抗锇
Maybe=也许
Glyceryl=甘油基
Molybdenum=钼
I=一世
Signal=信号
IV=IV
II=II
running=运行
Iron=铁
IN=在
Anti-Unpentoctium=抗Unpentoctium
Turbine=涡轮
Strengthened=加强
Unbitrium=Unbitrium
Bag=袋
Is=是的
Anti-Vanadium=抗钒
Motors=电机
It=它
Anti-Biquadennium=反二年纪
without=没有
In=在
Anti-Biennilium=抗双节菌
fermented=发酵
Slab=板坯
If=如果
Pink=粉
Washable=可洗
they=他们
Biennbium=Biennbium
Pewter=奖杯
Diesel=柴油机
Anti-Gravitonium=抗重霉属
Plastic=塑料
Pump=泵
Autoclave=高压灭菌
Conductive=导电
Molecular=分子
speed=速度
Anti-Biuntrium=抗Biuntrium
Log=日志
Sterling=英镑
Sandwich=三明治
generator=发电机
Anti-Tritrioctium=抗三叉戟
Baj=Baj
Anti-Terbium=抗铽
Bihexennium=双年展
Drop=下降
Anti-Unquadoctium=反Unquadoctium
lets=让我们
Steeleaf=Steeleaf
pile=桩
decalcify=脱钙
Olive=橄榄
Referencing=参考
Adamant=Adamant
Harvest=收成
Biocthexium=生物化学
real=真实
Tribiseptium=三枯菌
around=周围
Potato=土豆
Untyped=非类型
vacuus=真空
glitched=毛刺
Triseptnilium=三萜
Radon=氡
Talc=滑石
using=使用
Cryotheum=冷冻
Vermiculite=蛭石
Shovel=铲
Pin=销
Anti-Biseptennium=抗双酚
Shard=碎片
Pig=猪
Switches=开关
Galvanized=镀锌
Sulfide=硫化物
Sludge=污泥
Sharp=尖锐
Rounds=回合
Low=低
Cheatiness=欺骗
Trienntrium=Trienntrium
Anti-Biunnilium=抗双翅目
Anti-Unhexoctium=抗unhexoctium
Biseptnilium=双嘧啶
Master=主
specified=指定
Vitriol=矾
Furnace=炉
Mayonnaise=蛋黄酱
Anti-Gold=反金
Fiber=纤维
Polyatomic=多原子
Asbestos=石棉
Men=人
Ambrosia=神的食物
StrengthenedTerrasteelAlloy=强化Tasteel合金
Kaolinite=高岭土
T7=T7
Anti-Trihexhexium=抗三己铵
Anti-Triennunium=抗三年
Ruby=红宝石
Recipes=食谱
nuggets=掘金
ovens=烤箱
Unpenthexium=不老
Wooden=木
RawTerrasteelAlloy=RawTerrasteel合金
Vitreus=Vitreus
Tribiquadium=三面体
Slowness=缓慢
Rock=岩
Fabricator=制造商
throw=扔
on=上
Cast=投
of=的
Radium=镭
powered=电源
Unennilium=Unennilium
Paper=纸
Pyrosulfate=焦硫酸盐
Anti-Neodymium=抗钕
Hoes=锄头
Diorite=硅藻土
or=要么
Heads=头
No=没有
Bowl=碗
Reboot=重启
Lava=岩浆
Anti-Untriennium=反新千年
Paint=涂料
Add=加
Barley=大麦
Citrine=茶晶
Helium-Neon=氦氖
Stacksize=堆叠
your=你的
Empty=空
Week=周
ENERGY.AIR=能源
Combination=组合
Foam=泡沫
Blacklist=黑名单
start=开始
Dryer=烘干机
Cookie=曲奇饼
juiced=榨汁
Anti-Dysprosium=抗镝
Infinite=无穷
Anti-Triunnilium=抗三角膜
Anti-Lithium-6=抗锂-6
NU=NU
Anti-Unpentseptium=抗真菌
Electrometer=静电计
Gemstones=宝石
Anti-Bohrium=反Bohrium
Crunchy=脆脆
Anti-Ytterbium=抗镱
Phosphate=磷酸盐
Small=小
Anti-Bitrioctium=抗Bitrioctium
Binilseptium=二ils
Mirabilite=芒硝
Welding=焊接
Heavy=重
Thaumium=ium
bucket=桶
confuse=迷惑
Cauldron=釜
HDD=HDD
dirty=脏
Anti-Tripentquadium=抗Tripentquadium
Knightmetal=骑士
Twig=枝条
Biennunium=双子叶
Osmonium=奥斯蒙
Time=时间
Hoe=锄
USB=USB
Anti-Radon=抗氡
Anti-Biseptseptium=抗双抑菌素
Sodalite=方钠石
Anti-Tripentunium=抗Tripentunium
How=怎么样
Hot=热
Aer=Aer
au=au
at=在
steeping=浸泡
Caesium=铯
An=一个
Neutron=中子
Cutter=刀具
Tapazite=磷酸钙
4.0=4.0
want=想
extract=提取
Chum=密友
Pill=丸
Dark=黑暗
Anti-Triseptennium=抗三萜
5=5
Purpose=目的
Meatrose=肉类
Anti-Bihextrium=抗Bihextrium
you=您
Unpentquadium=Unpentquadium
Saws=锯子
Biquadpentium=Biquadpentium
Wide=宽
Hoppers=漏斗
Non-Metal=非金属
Element=元件
Certus=Certus
0:22=0:22
Glowstone=辉光石
Tinder=Tinder
CNC=CNC
included=包括
Notch=缺口
Tubes=管
Holy=圣
controlled=受控
Anti-Protactinium=抗真菌
Thermal=热
mass=质量
Pitch=沥青
once=一旦
Warts=疣
all=所有
Elven=精灵
forget=忘记
Unocthexium=异十六烷
Unknown=未知
Tube=管
Damage=损伤
Anti-Gregorium=抗Gregorium
Connects=连接
Take=采取
zinc=锌
Thulium=铥
Anti-Triennbium=抗三萜
Blades=刀片
Brown=棕色
white=白色
Kanthal=Kanthal
C-Foam=C泡沫
to=至
Anti-Unhextrium=抗Unhextrium
IrridantReinforced=IrridantReinforced
Beewax=Beewax
Precious=珍贵
Gunpowder=火药
Anti-Astatine=抗蛔虫
Anti-Triquadoctium=反三叠纪
Tripwires=Tripwires
overpowered=过度
very=非常
Sunstone=太阳石
BLANK=空白
Carmot=卡门
Unoctbium=Unoctbium
Salt=盐
Copper=铜
Portals=门户
Hamburger=汉堡包
Don't=别
Mossy=苔藓
Manasteel=Manasteel
Neon=氖
large=大
Juice=果汁
Anti-Bipenthexium=抗双白蛋白
Nitrogen=氮
small=小
Anti-Unpentbium=防锰
Ring=环
Anti-Bibiseptium=抗二硫化物
Needs=需要
Crystallisable=可结晶
GUI=GUI
Chargers=充电器
Only=只要
Anti-Unbibium=抗Unbibium
Dressing=敷料
ENERGY.VIS_PERDITIO=ENERGY.VIS_PERDITIO
Sulfur=硫
Anti-Sulfur=抗硫
will=将
what=什么
Yttrium=钇
Regenerating=再生
Mercassium=钾
Bibiennium=双年展
Triquadbium=三锑
Tungstensteel=钨钢
Rotation=回转
recharge=充值
Totally=完全
method=方法
Mica=云母
Anti-Boron=抗硼
Trihexnilium=Trihexnilium
full=充分
Anti-Rhenium=抗铼
Unquadnilium=。
FoolsRuby=傻瓜
operating=操作
Wollastonite=硅灰石
WolframCarbide=WolframCarbide
Trinitanium=三钛
Pulp=纸浆
Bitrioctium=枸杞
Unpentnilium=Unpentnilium
Pyrite=黄铁矿
Unseptbium=无锑
Triennunium=Triennunium
Enderium=Enderium
Trihexennium=三年
Ununoctium=Ununoctium
Anti-Rutherfordium=反Rutherfordium
amount=量
Cans=罐头
options=选项
Mendelevium=钔
Devil=魔鬼
Anti-Proton=抗质子
Top=最佳
Triunoctium=三疣
Plates=板
Bienntrium=Bienntrium
Charging=充电
select=选择
Unbiunium=Un
Ordinary=普通
Egg=蛋
Peat=泥炭
Overworld=Overworld
Anti-Tripentseptium=抗Tripentseptium
Anti-Binilseptium=抗二肽
Boiler=锅炉
Tennantite=Tennantite
Minions=小仆
Stew=炖
teleports=传送
Triseptseptium=三肽
Oak=橡木
Trinilpentium=三铌
Cider=苹果酒
Sifting=筛选
Cinnabar=辰砂
Not=不
Iridium=铱
Mass=质量
GarnetYellow=GarnetYellow
Perditio=Perditio
Fairy=仙女
Anti-Tritriquadium=抗三碱
Anti-Unquadbium=防反氚
Cheese=起司
Hardening=硬化
Anti-Tritium=抗氚
Anti-Unennunium=反Unennunium
Gods=神
der=der
Gasses=气体
Dynamos=Dynamos
Day=天
Anti-Silicon=抗硅
4:00=4:00
Martian=火星
Creeperweed=Cre草
Ink=墨水
Chunks=块
Your=你的
false=假
Anti-Biquadpentium=抗二价钯
Liveroot=Liveroot
Persulfate=过硫酸盐
Uranium=铀
Chests=胸部
Microwave=微波
Prefixes=前缀
Fuel=汽油
Fermenter=发酵罐
Triquadquadium=Triquadquadium
Anti-Natrium=抗Natrium
Icosagen=Icosagen
Bitter=苦
Hidden=隐
ENERGY.VIS_AQUA=ENERGY.VIS_AQUA
Anti-Bioctoctium=抗生素
awkward=尴尬
Vis=Vis
Wood=木
automatic=自动
Fusion=融合
Cryo=低温
Anti-Biquadhexium=抗二肽
Shadow=阴影
Vibramantium=。
Vinegar=尖酸刻薄
Blank=空白
Gallium=镓
Dog=狗
Celenegil=Celenegil
Refractory=耐火
Berries=浆果
Anti-Uranium238=抗铀238
Emit=发射
a=一个
Tritripentium=Tritripentium
Unennbium=Unennbium
Milkwart=Milkwart
Sweet=甜
Tritriennium=三年期
Deep=深
assign=分配
Player=播放器
Bandwidth=带宽
Dough=面团
File=文件
Slots=插槽
Anti-Lawrencium=抗藜
Anti-Unoctpentium=抗非铽
that's=那是
Storages=存储
Anti-Tritriseptium=抗三氚
don't=别
Purple=紫色
Anti-Neutrino=反中性
0:33=0:33
Simplifiable=可简化
through=通过
Bear=熊
its=它的
Igniting=点燃
Teleports=传送
Full=充分
20=20
Curium=锔
Anti-Neon=抗霓虹灯
Sanguinite=Sanguinite
Sharpener=卷笔刀
Prospector=探矿者
Voltage524288=电压524288
Chloroauric=氯金酸
Peridot=橄榄石
Bar=酒吧
Anti-Binilennium=反二年
Pasta=意大利面
Bad=坏
BeeWax=蜂蜡
ZPM-UV=ZPM-UV
Agate=玛瑙
Cracked=破裂
Anti-Adamantine=反金刚烷
components.This=组件
easily=容易
Tar=柏油
Lodestone=Lodestone
always=总是
Chunk=块
CHEEEEESE=CHEEEEESE
2x=2x
Resistance=抵抗性
Plank=板
Connections=连接
Raw=生的
Anti-Unbiunium=反Unbiunium
ON/OFF=开关
WrougtIron=WrougtIron
turns=转
found=发现
Leftclick=左击
End=结束
delicious=美味的
weight=重量
Rose=玫瑰
Anti-Gallium=抗镓
Mud=泥
oil=油
Pile=桩
expect=期望
Cure=治愈
Chloride=氯化物
Shaves=刮胡子
Biunseptium=Biunseptium
More=更多
Engine=发动机
Medium=中
Anti-Bihexpentium=抗Bihexpentium
Oxygen=氧
Anti-Triennennium=反三年期
Flax=亚麻
Trihexoctium=三六叶
McKenner=McKenner
Construction=施工
Anti-Triunpentium=抗三萜
Cyan=青色
Meltable=Meltable
Serpentine=蛇纹石
None=没有
Hour=小时
Anti-Triennilium=抗三叶草
Plutonium244=钚244
Squeezer=压榨机
Ignore=忽视
reason=原因
Sugilite=Sugilite
imagine=想像
EU=欧洲联盟
Tallow=脂
EV=EV
Trinilseptium=三硝基苯
Block=块
Unhexbium=六价铬
Barite=重晶石
Freezer=冰箱
terrible=可怕
Shape=形状
Anti-Americium-241=抗ium 241
Guffium=Guffium
Bin=bin
reinforced=加强
Huge=巨大
Clean=清洁
LuV-ZPM=LuV-ZPM
Trioctseptium=三萜
Axes=轴
Unpentunium=Unpentunium
liquefied=液化
Olivine=黄绿
Anti-Tripentbium=抗Tripentbium
re-ordering=重新排序
Fry=炒
guess=猜测
Anti-Triseptbium=抗三肽
Dictionary=字典
Anti-Unseptquadium=抗非肽
interact=相互作用
Precision=精确
metals.This=金属
Zombie=僵尸
Bobs-Yer-Uncle-Berry=Bobs-Yer-Uncle-Berry
accept=接受
Packager=打包机
Anti-Mercury=反汞
Dolamide=Dolamide
too=太
Unpentbium=Unpentbium
Free=自由
Constantan=康斯坦丁
Fries=薯条
because=因为
Anti-Uranium-235=抗铀-235
Eggplant=茄子
Anti-Untriunium=反非孤独
Biennseptium=Biennseptium
Stacks=堆栈
Lenses=镜头
Reinforced=加强
Factor=因子
Nut=坚果
Lathe=车床
Anti-Trinilnilium=抗三亭
Regeneration=再生
Transparent=透明
Rotating=旋转
Click=点击
Invisibility=隐形
Gilded=镀金
Magnesite=菱镁矿
Anti-Cobalt-60=抗钴-60
Elemental=元素
Idea=理念
Breath=呼吸
1:07=1:07
Anti-Bioctbium=抗生素
alike=一样
Crude=原油
Got=得到
Anti-Untribium=反非法
Anti-Tungsten=抗钨
Unseptseptium=无障碍
Explosive=爆炸
Anti-Biquadunium=抗二ium
Mushroom=蘑菇
depending=依赖
Food=餐饮
Chisels=凿子
Unquadbium=不倒翁
Anti-Krypton=抗氪
also=也
Generated=生成
Anti-Triocttrium=反三极管
AshDark=AshDark
With=与
Sides=边
Germans=德国人
Rutile=金红石
Radioactivity=放射性
Anti-Triunbium=抗三bium
Bibiquadium=联合
Pinalite=Pinalite
Oatmeal=麦片
Magnet=磁铁
Morganite=摩根石
3x=3x
Anti-Untrihexium=抗非穿透
nothing=没有
Fresh=新鲜
The=的
Dysprosium=镝
Sticks=棍子
Assembler=汇编
Crate=箱
Anti-Bibiunium=抗Bibiunium
Biquadseptium=二萜
clean=清洁
Springs=弹簧
Oilberries=油莓
Speed=速度
Adamantine=金刚
Ham=火腿
Triquadennium=三年
Wiring=接线
Signals=信号
Pages=页面
Aurelia=Aurelia
Has=具有
Sensor=传感器
Spicy=辣
Dirt=污垢
directly=直
less=减
Heat=热
gooey=gooey
Anti-Flerovium-298=抗Flerovium-298
Electrotine=电活化
Base=基础
Neutronium=中子
Anti-Untriseptium=抗无菌
Grid=格
Tripentoctium=Tripentoctium
Based=基于
Crucible=坩
Magic=魔法
Cooker=电磁炉
Quintuple=五元组
Anti-Tribiquadium=抗三裂
Cooked=煮熟
Tantalum=钽
Set=组
Anti-Unpenttrium=抗Unpenttrium
Unquadhexium=不倒翁
Soldering=焊接
Hearts=心脏
Minutes=分钟
Display=显示
Joshen=乔森
Bipentpentium=双五价
remove=去掉
Dull=愚钝
investigate=调查
Lawrencium=ium
Anti-Aluminium=防铝
Desichalkos=Desichalkos
Bluestone=青石
Molten=熔化
engraved=刻
Anti-Bipentnilium=抗黑癣
Monazite=独居石
set=组
For=对于
Anti-Hydrogen=抗氢
Unennpentium=Unennpentium
Triniltrium=三角膜
Stolzite=Stolzite
Anti-Tantalum=防钽
Anti-Bismuth=抗铋
see=看到
manly=男子气概
are=是
Anti-Niobium=抗铌
Potash=钾盐
Gravel=碎石
Plasma=等离子体
Nikolite=尼古拉
Printer=打印机
Anti-Unoctseptium=抗真菌
ENERGY.MINECRAFT_JOULES=ENERGY.MINECRAFT_JOULES
Barium=钡
Bobsyeruncleranks=Bobsyeruncleranks
Thorium=钍
Terra=Terra
Anti-Chromium=抗铬
Part=部分
Printed=打印
Tritriseptium=三氚
Anti-Ununennium=反千年
donate=捐
Trihexhexium=三己芬
incinerates=焚烧炉
carbonated=碳酸
seeded=播种
creating=创造
Pyrope=Pyrope
Triennilium=三叶草
Trinium=氚
Manual=手册
Server=服务器
Anti-Europium=抗铕
Sand=砂
Cures=治愈
Separator=分隔器
Ignition=点火
Triquadhexium=三重六
Crowbar=撬棍
improved=改进
reverse=相反
Oureclase=Oureclase
Melts=熔化
Fish=鱼
Anti-Plutonium244=抗钚244
baking=烘烤
ParaffinWax=石蜡
Anti-Triquadbium=抗三锑
Farms=农场
let=让
Yes=是
Inventories=库存
whole=整个
Emptying=排空
Temperature=温度
simple=简单
sweet=甜
Clay=粘土
Actinide=锕系元素
simply=只是
Mutation=突变
Wax=蜡
Weight-O-Meter=重量O-Meter
Pranks=恶作剧
ONIONS=洋葱
Biunhexium=Biunhexium
Chumburger=Chumburger
Voltage128=电压128
create=创建
Processing=处理
Cart=大车
Dubnium=Dubnium
Tribiennium=三年
Portal=门户
Lignite=褐煤
Unoctnilium=Unoctnilium
Elite=精英
empty=空
Women=妇女
Casing=套管
antimony=锑
Anti-Molybdenum=抗钼
ABSOLUTELY=绝对
Anti-Tripentnilium=抗Tripentililium
Emo=Emo
Shards=碎片
Anti-Unquadhexium=抗不愈合
else=其他
Switch=开关
Anti-Tritriunium=抗真菌
Drill=钻头
Pick=挑
Unhexpentium=未熟
List=列表
Anti-Trioctseptium=抗三氯皮苷
ignis=点火
Old=旧
Slower=慢点
solid=固体
Garnet=石榴石
Misc=杂项
Cobalt=钴
Endium=Endium
while=而
tweaking=调整
Cuts=削减
Manyullyn=Manyullyn
Stupidness=愚蠢
Cola=可乐
Triunhexium=三六六
Joules=焦耳
Celestine=Celestine
Tip=小费
Invalid=无效
Bitriquadium=Bitriquadium
itself=本身
Anti-Bisepthexium=抗双消胆
rid=摆脱
MJ=MJ
Luminite=萤石
Hydrated=水合
MU=亩
Eyes=眼睛
Anti-Bitrihexium=抗Bitrihexium
Ingot=锭
Salad=沙拉
8:00=8:00
Anti-Trinilbium=抗三铌
Seed=种子
Roasting=焙烧
Many=许多
Bitriunium=Bitriunium
Annealed=退火
Organic=有机
Endereye=Endereye
Plutonium-243=钚-243
Insert=插
Plutonium-241=钚-241
used=用过的
Anti-Fermium=抗菌
Paraffinwax=石蜡
Alkali=碱
Item=项目
moving=移动
cleaning=清洗
Activity=活动
Anti-Triseptnilium=抗三萜
Shiny=闪亮
Charged=带电
Anti-Triquadseptium=抗三喹啉
Power=功率
ENERGY.ELECTRICITY=能量
Almost=几乎
Anti-Cobalt=抗钴
Invisium=Invisium
Clicking=点击
Tastes=口味
Anti-QuickSilver=防QuickSilver
Soy=大豆
Kinetic=动力学
Tools=工具
Unennseptium=Unennseptium
Triseptbium=三卟啉
Baguette=法国面包
Honeydew=甘露
Yellorite=Yellorite
Smelter=冶炼厂
Migmatite=混合物
Buttons=纽扣
Felines=猫科动物
Tall=高
Files=文件
Baguettes=长方形宝石
cut=切
Compressor=压缩机
Anti-Tripentoctium=抗Tripentoctium
Flour=面粉
Incompetence=无能
Chocolate=巧克力
Anti-Darmstadtium=抗达姆施塔特
Fishy=腥
Anti-Biunoctium=抗生素
Front=面前
Oilsands=油砂
Dilithium=二锂
Tetroxide=四氧化
Chips=芯片
surprised=惊讶
harvesting=收获
Trinilhexium=三六六
Faster=更快
Anti-Technetium=抗锝
Of=的
Opal=蛋白石
EV-IV=EV-IV
Air=空气
WolframSteel=WolframSteel
Sub-Rail=子轨
ZPM=ZPM
Magnesium=镁
Diatomic=双原子
Unoctquadium=Unoctquadium
Or=要么
Hoarding=囤积
RomanVitriol=RomanVitriol
Anti-Yttrium=抗钇
Scanner=扫描器
Slicer=切片机
Computing=计算
Biomass=生物质
Sliced=切片
Netherrack=Netherrack
Anti-Triunennium=反三年
Anti-Neptunium=抗ium
Unquadoctium=Unquadoctium
Fine=精细
Replicator=复制器
Biunbium=铌
Lemon=柠檬
Gabbro=Gabbro
Screws=螺丝
Sandstone=砂岩
back=背部
applications=应用程序
Luminometer=发光计
Unquadquadium=Unquadquadium
ENERGY.VIS_ORDO=ENERGY.VIS_ORDO
Pentlandite=黄铁矿
ontop=在上面
0:16=0:16
sized=大小
String=串
Fire=火
per=每
Anti-Trinilennium=反三年纪
Anti-Curium=抗贪
Vacuum=真空
Sensors=传感器
Cardboard=纸板
Box=框
Boy=男孩
Loom=织机
run=跑
Anti-Bibipentium=抗Bibipentium
Particle=粒子
rum=朗姆酒
processing=处理
Tripenttrium=Tripenttrium
Anti-Unennseptium=抗Unennseptium
Trioctunium=三ium
Nitro-Fuel=硝基燃料
Unstable=不稳定
Fruits=水果
Pickaxes=镐
Placebo=安慰剂
by=通过
Biennoctium=双子叶
Sifter=筛子
anything=任何东西
Jade=玉
Rod=竿
Cocoa=可可
Kelvin=开尔文
Binilquadium=Binilquadium
canning=罐头
Trinaquadalloy=Trinaquadalloy
Anti-Biunquadium=反Biunquadium
into=进入
Logic=逻辑
Anti-Unennpentium=反Ununentium
Dacite=Dacite
Bitrihexium=百日咳
Blaze=火焰
Villagers=村民
Turquoise=绿松石
Used=用过的
Gaseous=气体
Nitro=硝基
Almandine=阿尔曼定
interacted=互动
Minecraft=我的世界
Unbihexium=Unbihexium
Triseptoctium=三萜
Uses=用途
Vision=视力
Anti-Untrinilium=抗解毒
creosote=杂酚油
Triunennium=三年
Pizzas=比萨饼
Steel=钢
Anti-Trihexbium=抗三乙炔
Animals=动物
Chalk=粉笔
Fermium=Fermium
properly=正确
Aura=光环
Mobs=暴民
Granitic=花岗岩
Naquadah=Naquadah
Gibbl-O-Meter=Gibbl-O-Meter
Bibinilium=碧苇
Visuals=视觉
Glauconite=海绿石
Limoncello=柠檬酒
Anti-Bipentpentium=抗双五萜
Recipe=食谱
Books=图书
Bihexoctium=Bihexoctium
Vinteum=Vinteum
Anti-Palladium=反钯
similar=类似
called=称为
Bitumen=沥青
Extinguishing=灭火
away.This=离开
Metalloid=准金属
Fluorite=萤石
Anti-Bienntrium=抗Bienntrium
Anti-Unbinilium=抗 - 逆转录病毒
Trihexunium=三萜
Ice=冰
Attack=攻击
cure=治愈
Garnierite=Garnierite
TungstenSteel=钨钢
cafe=咖啡店
Bentonite=膨润土
Fuels=燃料
Anti-Naquadria=抗Naquadria
May=可能
Unennennium=一年
TU=TU
Uvarovite=Uvarovite
Steeleafranks=Steeleafranks
Default=默认
Anti-Unquadennium=反十九世纪
buddle=佛
Outputs=输出
Man=人
TNT=TNT
Blizz=暴雪
Ytterbium=镱
energetic=精力充沛
T8=T8
Shelves=货架
favourite=喜爱
Smeltable=可熔
T4=T4
T5=T5
T2=T2
T3=T3
T0=T0
T1=T1
Flux=助焊剂
Anti-Unbipentium=抗Unipipentium
AU=AU
Output=输出
Automatically=自动
Bisepthexium=Bisepthexium
Limestone=石灰石
RedRock=RedRock
Anti-Unocttrium=抗unocttrium
Bathing=沐浴
required=需要
Tritritrium=Tritritrium
Lumium=Lumium
As=如
Anti-Unhexbium=防老化
Phosphor=磷
Unsepthexium=未过滤
fresh=新鲜
having=有
Trioctennium=三年
Mercury=汞
Cupronickel=Cupronickel
Self=自
Coins=硬币
Ash=灰
Rails=Rails
cobalt=钴
Anti-Silver=反银
toggle=切换
tooltip=工具提示
go=走
Progress=进展
Anti-Argon=反氩
Anti-Triennoctium=抗三年教
Crucibles=Crucibles
Binilhexium=Binilhexium
Anti-Bipentquadium=抗双。
Object=目的
metallurgy=冶金
Glass=玻璃
Anti-Magnesium=抗镁
Injector=注射器
BandedIron=BandedIron
Now=现在
Superconductor=超导体
Phosphorus=磷
Bismuth=铋
Anti-Wolframium=反战争
Topaz=黄玉
Stuff=东东
autocraftable=autocraftable
Wheels=车轮
Breads=面包
Methane=甲烷
Anti-Plutonium=抗钚
magic=魔法
LV-MV=LV-MV
Trinitrate=三硝酸盐
Blitz=闪电
Anti-Erbium=抗铒
try=尝试
Anti-Unhexpentium=抗未熟化
transmutation=。变
Facings=面板
deleting=删除
Energized=电源
Functions=功能
Stats=统计
Sodium=钠
Vegetables=蔬菜
Radiation=辐射
Long=长
Binilennium=二千年
Equipment=设备
Anti-Helium-3=抗氦-3
Biunoctium=un
AshesDark=AshesDark
Calcite=方解石
Untrihexium=不织布
Anti-Trihexoctium=抗三节痛
Energetic=精力充沛
Tanzanite=坦桑石
Chainsaw=电锯
Reed=芦苇
Frying=油炸
Ore=矿石
Orb=Orb
Former=前任的
can=能够
Satinspar=Satinspar
Chipped=芯片
Locked=锁定
Biunpentium=Biunpentium
Nugget=金块
Light=光
Anti-Samarium=反钐
desired=需要
Green=绿色
making=制造
Claw=爪
RefinedGlowstone=精制石
incinerate=焚化
Anti-Praseodymium=抗镨
rightclick=右键点击
Energy=能源
30=30
Back=背部
Mawsitsit=Mawsitsit
Bipentseptium=两性霉素
Motor=发动机
Johnsons=约翰逊
Blossom=开花
Implosion=内爆
Generifier=发电机
Anti-Trienntrium=抗Trienntrium
Voltage2048=电压2048
Triocthexium=三o
Input=输入
Copernicium=Copernicium
Blueprint=蓝图
ALIEN=ALIEN
use=使用
Breathing=呼吸
from=从
Anti-Platinum=抗铂
Liters=升
next=下一个
Lens=镜片
Neutral=中性
Spessartine=Spessartine
Anti-Unhexseptium=抗Unhexseptium
touched=触摸
Count=计数
charcoal=木炭
Laser=激光
didn't=没有
Tribiunium=Tribiunium
Wither=枯萎
Bottle=瓶子
Triquadnilium=三萜
harvest=收成
Anti-Bihexseptium=抗Bihexseptium
Coin=硬币
Chimerite=嵌锂体
5000=5000
this=这个
Anti-Kalium=抗Kalium
Tofu=豆腐
Centrifugable=可离心
Berkelium=柏木
Liveroots=Liveroots
something=东西
Heaters=加热器
Anti-Triquadennium=反三年期
Chloroplatinic=氯铂酸
process=处理
Technetium=锝
pieces=件
high=高
Parts=部分
Details=细节
Huebnerite=Huebnerite
Anti-Carbon=防碳
Nuggets=掘金
Microcline=微线
noises=噪声
produces=产生
Drink=喝
recrystallising=重结晶
Hydrochloric=盐酸
Strontium=锶
Anti-Unhexunium=抗Unhexunium
Spray=喷雾
Cadmium=镉
instead=代替
Shows=显示
Inductive=电感
Chalcogen=硫属元素
Chisel=凿
Emery=金刚砂
Peppermint=薄荷
Lesser=小
Allow=允许
Alloy=合金
Vanadium-Gallium=钒镓
efficiently=有效率的
Untribium=未定
drop=下降
Apple=苹果
Crystal=水晶
light=光
Carrot=胡萝卜
Anti-Caesium=抗铯
Anti-Biniloctium=反蕨菜
Anti-Lead=反铅
Hammer=锤子
Technically=技术上
Tungstencarbide=碳化钨
ENERGY.NEUTRON=ENERGY.NEUTRON
Onyx=On玛瑙
move=移动
Fluids=液体
produced=生产
Meteorite=陨石
Elementium=元素
Biennpentium=双金属
Decolor=脱色
Capacity=容量
Washer=垫圈
Match=匹配
Mundane=Mundane
Unennquadium=Unennquadium
Anti-Triseptquadium=抗三肽
till=直到
Anti-Biunhexium=抗双盾
Fluid-O-Meter=流体O计
Anti-Bihexnilium=抗Bihexnilium
Anti-Unseptoctium=反Unsptoctium
Dye=染料
Idun's=Idun的
Palladium=钯
Dissolving=溶解
Solid=固体
Car=汽车
Cat=猫
Anti-Biennbium=抗双烯
Can=能够
das=das
front=面前
Raspite=Raspite
Meatless=无肉
Ports=端口
Triennbium=三铌
Pre=前
Ignored=忽略
Aluminium=铝
Disjunction=分离
Rhenium=铼
Anti-Binilquadium=反Binilquadium
Wiremill=Wiremill
Squid=乌贼
Why=为什么
Say=说
Triquadunium=三联
Raiding=Raiding
Saw=锯
Anti-Unseptseptium=抗非蛋白胨
ENERGY.VIS_IGNIS=ENERGY.VIS_IGNIS
Platinum=铂
Anti-Biunseptium=抗生素
Armor=盔甲
Poisonous=有毒
Dismounts=拆卸
Anti-Biseptquadium=抗双磷
know=知道
Phoenixite=菲尼克斯
Gregorium=Gregorium
Anti-Titan=反Titan
Johnson's=约翰逊
Nitric=硝酸
our=我们的
Harming=危害
special=特别
Duranium=硬
Very=非常
Bipentoctium=双趾虾
Cobaltite=钴铁矿
Demonite=Demonite
Diabolo=空竹
Store=商店
Uran=乌兰
Invar=因瓦尔
Anti-Trinilseptium=抗三硝基肽
Explodes=爆炸
Pane=窗格
This=这个
Alfium=铝
Erbium=铒
8x=8x
Thin=瘦
Triseptennium=三萜
Midasium=大地
additional=额外
Anti-Triquadquadium=反三联体
Biunquadium=Biunquadium
Rib=肋骨
could=可以
Bonemeal=Bonemeal
put=放
Trioctoctium=三o
times=次
Anti-Einsteinium=抗ium
cures=治愈
Bisulfate=硫酸氢盐
Rotates=旋转
Weeks=周
Anti-Bibioctium=抗胫骨
soldered=焊接
Lame=瘸
Anti-Bihexhexium=抗Bihexhexium
Swords=剑
JackHammer=杰克哈默
Anti-Trioctpentium=抗三锑
Rubber=橡胶
Bibibium=Bibibium
Electrical=电气
Bedrock=基岩
T9=T9
Snitches=Snitches
Unbioctium=。
between=之间
doesn't=没有
Coated=涂层
Unquadennium=不成立
Anti-Biennpentium=抗双核
Bihextrium=Bihextrium
Argon=氩
T6=T6
Tungstate=钨酸盐
Gibbl=吉布尔
Anti-Biseptpentium=抗双卟啉
Unocttrium=Unocttrium
Running=运行
Success=成功
Goshen=Goshen
Paraffin=石蜡
Anti-Tritribium=抗Tritribium
Niobium=铌
Calcium=钙
Gears=齿轮
Clears=清除
losslessly=无损
Plunger=柱塞
Heater=加热器
bismuth=铋
Mithril=Mithril
liquid=液体
Flawed=有缺陷
Universal=普遍
Anti-Ununoctium=抗Ununoctium
Cluster=簇
Praseodymium=镨
Zinc=锌
Casings=肠衣
Ununennium=Ununennium
Lime=青柠
1.0=1.0
Itarius=Itarius
Machine=机
Meitnerium=Meitnerium
Actinium=锕
MineTweaker=MineTweaker
have=有
need=需要
IV-LuV=IV-LuV
Oil=油
min=min
Photon=光子
Veggieburger=素汉堡
Unbiseptium=大麻
Healing=愈合
which=哪一个
Rolling=滚动
Anti-Cadmium=抗镉
Transition=过渡
Pirate=海盗
Canines=犬
Solution=解
Chert=燧石
said=说过
connected=连接的
Lonsdaleite=Lonsdaleite
Anti-Unquadnilium=抗未螨
Anti-Biennennium=反双年度
Processor=处理器
Bitriennium=三年
refreshing=刷新
Cyanite=蓝晶石
Pot=锅
Lemonade=柠檬汽水
Trihexpentium=三己基
Biseptpentium=双卟啉
FzDarkIron=FzDarkIron
Unseptnilium=无菌
NOTHING=没有
Earth=地球
Anti-Biunbium=抗铋
Anti-Scandium=防钪
Sheep=羊
Sunflower=向日葵
ENERGY.MAGNETIC=能源
Anti-Unseptunium=抗非。
Chemical=化学
Mutated=突变
touching=接触
Anti-Wolfram=反Wolfram
12x=12x
Selector=选择器
Anti-Antimony=反锑
Anti-Bitriquadium=反Bitriquadium
Anti-Chrome=防镀铬
with=与
Measures=措施
Gelatine=明胶
Robust=强大的
Strong=强大
Chlorine=氯
regularly=经常
Orichalcum=。
Unennunium=Unennunium
Unpentpentium=Unpentpentium
Coal=煤炭
Unhexunium=Unhexunium
made=制作
Trisepthexium=Trisepthexium
Biquadunium=Biquadunium
Randomite=随机
Mechanical=机械
Anti-Titanium=抗钛
Kalendrite=Kalendrite
Magarita=Magarita
Brass=黄铜
ENERGY.QUANTUM=能量
Aredrite=Aredrite
Epidote=Epidote
Because=因为
Ten=十
Unseptoctium=Unseptoctium
Move=移动
Proton=质子
Tearstalks=泪滴
Cd-In-Ag-Alloy=Cd-In-Ag合金
Grafter=Grafter
grab=抓
discovery=发现
UU-Amplifier=UU放大器
Anti-Rubidium=抗铷
Flammable=易燃
Redrock=Redrock
Niter=硝
Anti-Unseptnilium=抗非肽
Anti-Bioctseptium=抗生素
we=我们
BrickNether=砖Nether
Source=资源
Anti-Unbitrium=反Unbitrium
Anti-Tribiennium=反恐怖主义
Crystallogen=Crystallogen
Pulsating=脉动
Units=单位
Anti-Triunhexium=抗三六
Decomposable=可分解
Good=好
placed=放置
Corpseplant=Corpsplant
Magnetism=磁性
Anti-Unhexnilium=抗Unhexnilium
Anti-Bibihexium=抗Bibhexium
Infused=注入
Chromite=铬铁矿
Minute=分钟
Bihexpentium=Bihexpentium
Unhexseptium=Unhexseptium
Packets=数据包
Francium=钫
Manganese=锰
Silicon=硅
efficiency=效率
Anti-Phosphor=防磷光体
Axe=斧头
Bipentunium=双ium
staring=凝视
Bending=弯曲
Unpenttrium=Unpenttrium
Absorbers=吸收体
Anti-Unoctquadium=抗非电子
aqua=水色
Uranium-235=铀-235
Burger=汉堡包
Design=设计
Prospecting=勘探
Tritriquadium=Tritriquadium
Anti-Calcium=抗钙
clogged=堵塞
otherwise=除此以外
Extinguishes=熄灭
Extinguisher=灭火器
Transformer=变压器
When=什么时候
Pokefennium=Pokefennium
Malachite=孔雀石
Refractorywax=耐火蜡
Leaks=泄漏
Anti-Biennseptium=抗双酶床
Nobelium=Nobelium
Osmium=锇
Brick=砖
Filled=填充
Positron=正电子
Pressure=压力
Alkaline=碱性
Darmstadtium=达姆施塔特
slowly=慢慢地
certain=某些
Powellite=Powellite
Anti-Adamantium=反Adamantium
Gem=宝石
Anti-Iron=抗铁
internals=内部
nickel=镍
Soylent=Soylent
Anti-Chlorine=抗氯
Dragon=龙
Anti-Triquadtrium=反三叠纪
Foils=箔
Leninade=Leninade
an=一个
Bibioctium=胫骨
Force=力
Wimalite=Wimalite
Recycler=回收机
Bricks=砖头
Ceruclase=核酸酶
harder=更难
as=如
Cubic=立方体
harden=硬化
Anti-Bitriennium=反三年
Magnets=磁铁
Anti-Bihexoctium=抗Bihexoctium
Roentgenium=芸苔
Any=任何
Gypsum=石膏
Voidstone=虚空石
Hops=酒花
Pipes=管道
Anti-Biquadquadium=反二价铜
Zeolite=沸石
Chest=胸部
Mob=暴民
Granite=花岗岩
Californium=。
You=您
Autocrafter=自动人工
Anti-Triununium=抗三联
Triuntrium=三重奏
NULL=空值
Anti-Unocthexium=抗unhexctium
Biocttrium=生物化学
Unquadseptium=无危险
Crops=作物
Regular=定期
Anti-Bibinilium=抗铍
Biquadbium=Biquadbium
Tritrihexium=三硝基苯
Safes=保险箱
Emits=发射
Panel=面板
Aluminum=铝
Anti-Bitribium=抗Bitribium
Coral=珊瑚
drink=喝
Bucket=桶
effect=影响
Untrioctium=不分枝
Coppon=Coppon
Nether=虚空
Anti-Bihexquadium=抗Bihexquadium
Ardite=Ardite
Graphite=石墨
Inolashite=Inolashite
Seconds=秒
Anti-Mac-Guffium=反Mac-Guffium
Order=订购
HV-EV=HV-EV
Tartarite=鞑靼
Straw=稻草
Spring=弹簧
well=好
Item-O-Meter=项目O-Meter
States=状态
Anti-Bibiquadium=抗双链球菌
Voltage32768=电压32768
Burnable=可燃
Thaumic=Thaumic
Macerator=指挥
Flower=花
stores=商店
BC=公元前
Gems=宝石
Cave=洞穴
Antimatter=反制
Chrysotile=温石棉
stored=存储
Lubricant=润滑剂
Anti-Biennoctium=抗双节瘤
chiselable=可凿
Remaining=剩余
consume=消耗
Trinilquadium=Trinilquadium
Unhexnilium=Unhexnilium
AshVolcanic=AshVolcanic
Naquadria=Naquadria
Uranium238=铀238
Cover=盖
Scannable=可扫描
Pigs=猪
Diablo=暗黑破坏神
Anti-Trioctquadium=反三角形
Ununtrium=Ununtrium
Solidifier=固化剂
Certificate=证书
Soulsand=Soulsand
Trinilnilium=三ium
Unbiquadium=Unbiquadium
Byproduct=副产品
Components=组件
IC2=IC2
crushes=粉碎
Anti-Trinilquadium=抗三育
Proof=证明
Cookies=饼干
Tick=蜱
like=喜欢
Vile=Vile
Anti-Triuntrium=反三极管
Antidote=解毒剂
FZDarkIron=FZDarkIron
ENERGY.VIS_TERRA=ENERGY.VIS_TERRA
Honey=蜜糖
Foods=食品
Jasper=碧玉
Lasers=激光
become=成为
works=作品
Corium=真皮
Scale=规模
Anti-Zinc=抗锌
Possible=可能
Cerium=铈
Extenders=扩展
Biunnilium=双子叶
Glowing=发光
loaded=加载
Anti-Binilunium=反二年
Carton=纸箱
Pnictogen=Pnictogen
Hassium=钾
Wolfram=钨
Alloys=合金
transmutations=变化
lead=铅
Stannite=锡石
Bromine=溴
does=是的
Unoctennium=未成年
Anti-Uranium=反铀
Extractor=提取器
Anti-Unbiquadium=抗Unbiquadium
Biennilium=双子叶
coated=涂层
Biseptunium=ium
Circuits=电路
ULV=ULV
Robot=机器人
Scoop=舀
Range=范围
Anti-Barium=抗钡
Energizer=激励
Canning=罐头
Anti-Nickel=抗镍
Mill=磨
about=关于
Sap=树液
actual=实际
Reactor=反应堆
UU=UU
UV=UV
RefractoryWax=耐火蜡
Meters=米
Crystals=晶体
Rods=杆
Anti-Iodine=抗碘
Neodymium=钕
Unburnable=不可燃
Tripentseptium=Tripentseptium
Grape=葡萄
Unhexoctium=。
Unpackager=解包
functional=功能
tiny=小
Anti-Fluorine=抗氟
Anti-Unoctbium=抗Unoctbium
Tritribium=Tritribium
FUS=FUS
Phosphorite=磷酸盐
Sunnarium=日ium
ENERGY.KINETIC_PUSH=ENERGY.KINETIC_PUSH
Boxes=盒子
Scanners=扫描仪
Unused=没用过
Scythe=镰
Anti-Unquadpentium=反未定量
Grapes=葡萄
Dust=灰尘
Chili=辣椒
Trihexseptium=三己基
Bisepttrium=双菌门
Shredder=粉碎机
Petrified=石化
alcoholic=酒精
Science=科学
Paperboard=纸板
Spinel=尖晶石
but=但
Anti-Americium=抗美容
Shiftclick=Shiftclick
Pollucite=铯榴石
Balance=平衡
eat=吃
Wolframium=Wolframium
Industrial=产业
Garbage=垃圾
Gold=金
Tea=茶
Biseptoctium=Biseptoctium
harvested=收获
Anti-Binilnilium=反铊
Rightclicks=右键
Chromium=铬
Bottles=瓶
entering=进入
Rye=黑麦
Nutella=花生酱
UU-Matter=UU-Matter
Cake=蛋糕
Bottled=瓶装
Bitripentium=Bitripentium
Lithium=锂
Chiseled=凿子
Containers=容器
Measuring=测量
Emblem=徽
Liquid=液体
Anti-Seaborgium=防海藻
Anti-Trioctbium=抗三锑
Million=百万
DAH=DAH
Shale=页岩
Saltpeter=硝
Delivery=交货
other=其他
Desh=Desh
Boron=硼
Untritrium=Untritrium
conclusion=结论
CoffeeDust=咖啡尘
Loss=失利
junk=垃圾
Like=喜欢
Alcopops=铝合金
dismantle=拆除
Funnel=漏斗
stay=留
Chronometer=天文钟
Sapphire=蓝宝石
Xenon=氙
Wheat=小麦
QuickSilver=水银
Marble=大理石
Anti-Triennhexium=抗三年休
Wirelamp=Wirelamp
Primitive=原始
LuV=LuV
4x=4x
Vulcanite=钒酸盐
Alumite=氧化铝
write=写
baken=baken
Anti-Unhexhexium=抗破伤风
Refined=精制
Bloodstone=鸡血石
